--------------------------------------------------------------------------------------------------------------------------------------------------------------
--------------------------------------------------------------------------------------------------------------------------------------------------------------
S-----SSSSSSSSSSSSSSSSSSSSSSSSSSSSSSSSSSSSSSSSSSSSSSSSSSSSSSSSSSSSSSSSSSSSSSSSSSSSSSSSSSS?SSSSSSSSSSSSSSSSSSSSSSSSSSSSSSSSSSSSSSSSSSSSSSSS--------------------
S-----------------------------------------------------SS--SSSSSS--SSSS------SSSS------------------------------------------------------------------------------
S-----------------------------------------------------SS--SSSSSS--SSSS--E---SSSS------------------------------------------------------------XXX---------------
S----------------------------------------oooo-------SS--------SS---S----SS----------oooooo-----------------------------------------------------------------XXX
S-----------------------------o---------------------SS--------SS---S----SS------------------------------------------------------------------------------------
S--------------------------------------S-SSSS-S-----SS--------SS---S----SS----------SSSSSS--------------------------------------------------------------------
S----------------------------S---------SoS--SoS-----SS----ooooSS---So??-SS---E------SSSSSS--------------------E----------------------------------SSSSS??------
S---------QQQQQ--------XXXX------------SSS--SSS-----SSSS--SSSSSS---SSS--SS--SSSS------------------------E----<>-------------------------XXX-------------------
S--------------------XXXXXXXX--XX---------------------SS-------------------EE--------------------------<>----[]-----E-----SS-----------EXXX-XXX---------------
S------------------XXXXXXXXXX--XXXX-------------------SS-----------------------------------------------[]----[]----<>-----SS---------EXXXXX-------------------
S-------------EE-XXXXXXXXXXXXE-XXXX-------EE---------E------E--E--------------------------------E-EE---[]----[]--E-[]-----SS---------XXXXXX---------E---------
XXXXXXXXXXXXXXXXXXXXXXXXXXXXXXXXXXXXXXXXXXXXXXXXXXXXXXXXXXXXXXXXXXXXXXXXXXXXXXXX---XXXXXXXXXXXXXXXXXXXXXXXXXXXXXXXXXXXXX--XX--XXXXXXXXXXXX-------XXXXXXXX--XXX
