-----------------------------------------------------------------------------------------------------------------------------------------------------------------------------------------------------------------------
-----------------------------------------------------------------------------------------------------------------------------------------------------------------------------------------------------------------------
-----------------------------------------------------------------------------------------------------------------------------------------------------------------------------------------------------------------------
--------------------o--------------------------------------------------------------------------------------------------------------------------------------------------------------------------------------------------
-----------------------------------------------------------------------------------------------------------------------------------------------------------------------------------------------------------------------
------------------SSS-------E---------------------------------SSSSS-----SSSSS------------------------------E--S---SSSSSSSSS------------SS---SS-------------SSS-----E---------------------------------E---XXX-----------
---------------------------<>-----------------------------E------------------------E----------------------<>------------------------------------------------------<>------------------------------------XXXX-----------
---------------------------[]-----------------------E----<>-----------------------<>----------------------[]------------------------------------------------------[]-----------------------------------XXXXX-----------
---------------E--------E--XXX------------E--------<>----[]-----------------------[]--------------E-------[]-------------------------SS---------------------------[]------E--------E-----------------EXXXXXX-----------
-----SSS------<>---S---<>----------------<>---SS---[]----XXX----------------ES----[]------E------<>------SXXS------------------------------SSS-------E-XX--SSS----XXX----<>------E<>-----E----------<>XXXXXX-----------
--------------[]-------[]------E-E-------[]--------[]----------E------E----<>---E-[]-----<>------[]--E---------E---------------E---E--------------XX<>-XX----------------[]----E<>[]----<>----------[]XXXXXX-----------
--------------[]-------[]-----<><>-------[]--------[]---------<>-----<>----[]--<>-[]-----[]------[]-<>--------<>--------------<>--<>-------------XXX[]-XXX---------------[]---<>[][]----[]---------X[]XXXXXX-----------
--------------[]----E--[]-----[][]-------[]--------[]---------[]-----[]----[]--[]-[]-----[]------[]-[]--------[]--------------[]--[]------------XXXX[]-XXX--------E------[]---[][][]----[]--------XX[]XXXXXX-------XX--
XXXXXXXXXXXXXXXXXXXXXXXXXXXXXXXXXXXXXXXXXXXXXXXXXXXXXXXXXXXXXXXXXXXXXXXXXXXXXXXXXXXXXXXXXXXXXXXXXXXXXXXXXXXXXXXXXXXXXX------XXXXXXXXXXXX-X-XXXXXXXX-XXXXXXXXXXXXXXXXXXXXXXXXXXXXXXXXXXXXXXXXXXXXXXXXXXXXXXXXXXXXXXXXXXX
