--------------------------------------------------------------------------------------o---------XXXXXXXXXXXXXXXXXXXXXXXXXXXXXXXXXXXXXXXXXXXXXXXXXXXXXXXXXXXXXXXXXXX---------------------------------------------------------------------------------------------------
---------------------------------------------oo---------------------------------------o---------XXXXXXXXXXXXXXXXXXXXXXXXXXXXXXXXXXXXXXXXXXXXXXXXXXXXXXXXXXXXXXXXXXX------------------------------------------------------------------------------------oo-------------
--------------------------------------------------------------------------------------o-------------------------------------------------------------------------------------------------------------------------------------------------------------------------------
-------X------------------------------------------------------------------------------o--------------------------------------------------E-------------------------------------------------------------------------------------------------------------------E--------
--------------------------------------------------XXX---------------------------------o---------------SSSSSSSSSSSSSSSS----SSSSSSSSSSSSSSSS----SSSSSSSSSSSSSSSS------------------------E--------------------------------------------Q--E-----------------X---XXX-------
------------------------------------E--------E----XXX---------------SSS-SSS-----------o-------------------------------------------------------------------------------------------------E-----------------------------------------------E-------------------XXX-------
------------------------------------?------Q-<>------------Q--------------------------o------------X--------------------X-------------------X-----------------------------------------------------------------------------------------------XXX--X---Q-<>------------Q
---------------------------------------------[]---------------------------------------o----------E-------E------------E-----------------E-E------------------------------------------------------------------SSS----------------------------XXX--------[]-------------
----------------------------------------XXX--[]------XXX--------------------------------------XXXXXXXXXXXXXXXXXXSSXXXXXXSSXXXXXXXXXXSSXXXXXXSSXXXXXXXXXXSSXXXXXXSS----------------------------------------------------SSS---------QQQ-------XXX-<>XXX--[]------XXX----
----------------------------------------XX-E-[]------XXX--------------------------------------XXXXXXXXXXXXXXXXXX--XXXXXX--XXXXXXXXXX--XXXXXX--XXXXXXXXXX--XXXXXX--------------------------------------------------------------------------XXXXX-[]XXX-E[]------XXX----
-----------------E----------------------XXXXXXXXX-----XXXXXXX--------------------------------XXX-X-XXXXXX-----XXX-XXX-----XXX-----XXX-XXX-----XXX-----XXXEXXX-X-X-------------------------------------------------------------------------XXXXX-[]XXXXXXXXX-----XXXXXX
----------------XXXXXXXXXXXX-X-X-XXXXXXXXXXXXXXXX-----XXXXXXX--------------------------------XXX-X-XXXXXX-----XXXSXXX-----XXX-----XXXSXXX-----XXX-----XXXSXXX-X-X-------------------XXX-----------------XXX-------------------XX-E----XXX-XXXXX-[]XXXXXXXXX-----XXXXXX
----------------XXXXXXXXXXX------XXXXXXX---------------------------------------------------XXXX----------ooooooo--XX---------ooooooo--XX---------ooooooo--XX----------------------E-XXX-----------------XXX-------------------XXXXXXXXXXX-XXXXX-XXX-------------------
----------------XXX-----------------------------------------------------------------<>-E---------XXXXX---XXXXXXX------X--E---XXXXXXX------E-X----XXXXXXX----E-----XX-----E--------XXXXXX-------E------XXXXX-------------------XXX---------XXXXX-XXX-------------------
--XXXXXXXXXXXXXXXXX------------------------XXXXXXX----------------------------------[]XX--XXXXXX---X--XXX-------XXXXXXXXXXXXX-------XXXXXXXXXXXXX-------XXXXXXXXXX----XXXXXXXXXXXXXXXX----XXXXXXXXXXXXXXXXX-------------------XXX---------XX---------XXXXXXX----------
