----------------------------------------------------------------------------------------------------------------------------------------------------------------------------------------------------------------------------------------------------------------------------------------
----------------------------------------------------------------------------------------------------------------------------------------------------------------------------------------------------------------------------------------------------------------------------------------
--------------------------------------------------------------------------------------------------------------------------------QQ------------------------------------------------------------------------------------------------------------------------------------------------XX----
---------------------------------------------------------------------------------------o-----------------------------------------------------------------------------------------------------------------------------------------------------------------------------------------XXX-o--
---------------------------------------------------------------------------------E-----o----------------------------------------------------------------------------------------------------------------------------------------------------------------------------------------XXXX----
--------------------------------------------------------------------------------SSSSSS-o-------E-------------------------------------------------------------------------------------------------------------------------------------------------------------------------------XXXXX-o--
----------------------------------Q-------------------------------------------E--------o-------?------------------------------QQQQQQ------------------------------------------?---------------------------------------Q-------------------------------------------------------XXXXXX----
-------------------------------------------------------------------QSQSQ------<>-------o---------------------------------------------------------------------------------------------------QSQSQ------<>---------------------------------------------------------SSS---------XXXXXXX-o--
----------------------E-------------------------------------------------------[]-------o--------------------------------------------------------------------------------------------------------------[]----------------------------------------------------------------------o-o-o-----
-----Q----------------?----------------------Q--------------------------------[]-------o-----------------Q---------------------------------------Q----------------Q-----------------------------------[]--Q----------------------Q-----------------------------------------XXXXXXXXX-o--
---------------------------------------------------------------E--------------[]--Q-----------SSS---------------------------XXXXXXXXXX----------------------------------------E--------E--------------[]------------------------------------------------------------------XXXXXXXXXX----
-------------------------------X--XX-------------------------XXXXXXXXXXXXXXXXXXX-------------------------------------------------------------------------------------------X--XX-----XXXXXXXXXXXXXXXXXXX-----------X--XX---------------------------------------XXXXXX-----o-o-oXXXXX-o--
-<>-------X----------------<>--X--XX-----<>-------X----------X------------------X---X----------------<>-------X--------------------------X---<>-------X----------------<>--X--XX-----X------------------X------<>--X--XX-----<>-------X----------X--------XXXXXXXXXXX---XXXXXXXXXXXX----
-[]-----X-X------E---------[]--X--XX-----[]-----X-X----------X------------------X-X-X----------------[]-----X-X-E----------------------X-----[]-----X-X----------E-----[]--X--XX-----X------------------X-----E[-E-X--XX-----[]-----X-XE-----------E------XXXXXXXXXXX--XXXXXXXXXXXXX----
XXXXXXXXXXXXXXXXXXXXXXXXXXXXXXXXXXXXXXXXXXXXXXXXXXXXXXXXXXXXX-------------------XXXXXXXXXX-XXXXXXXXXXXXXXXXXXXXXXXXXXXXXXXXXXXXXXXXXXXXXXXX-XXXXXXXXXXXXXXXXXXXXXXXXXXXXXXXXXXXXXXXXX-------------------XXXXXXXXXXXXXXXXXXXXXXXXXXXXXXXXXXXXXXXXXXXXXXXX--XXXXXXXXXXXX-XXXXXXXXXXXXXXXXX
XXXXXXXXXXXXXXXXXXXXXXXXXXXXXXXXXXXXXXXXXXXXXXXXXXXXXXXXXXXXXXXXXXXXXXXXXXXXXXXXXXXXXXXXXX-XXXXXXXXXXXXXXXXXXXXXXXXXXXXXXXXXXXXXXXXXXXXXXXX-XXXXXXXXXXXXXXXXXXXXXXXXXXXXXXXXXXXXXXXXXXXXXXXXXXXXXXXXXXXXXXXXXXXXXXXXXXXXXXXXXXXXXXXXXXXXXXXXXXXXXXXXXXXX--XXXXXXXXXXXX-XXXXXXXXXXXXXXXXX
