----------------------------------------------------------------------------------------------------------------------------------------------------------------
----------------------------------------------------------------------------------------------------------------------------------------------------------------
-----------------------------------------ooo--------------------------------------------------------------------------------------------------------------------
-----------------------------------------o-o---------------------------?----------------------------------------------------------------------------------------
-------------------------------------------------------------------------------------------ooo---------------------ooooooooo------------------------------------
-----------------------------------------XXX-----------------------------------------------XXX-------------------XXXXXXXXXXXXX----------------------------------
-------------------oooo----------------------------------------------XXX--ooo-----------------------------------------------------------------------------------
-------------------oo-o---------------------------------------------------ooo---------------------------------------------------E------------------------E------
------------------------------------------------oooo-----------------------------------------------E------------------------------XXXX--------------------------
----------------------XXXXXXXXXXXXXXXX----------oooo-----------XXXXXXXXXXXX-----------XXXX-----XXXXXXXXXXXXXXXX-------------------------------------------------
-------------------------------------------------------------------------------------------------------------------------------------------XXXXX----------------
------------XXXXXXX---------------------------XXXXXXXXXXXXX-----------------------------------------------------------------------------------------------------
------------------------------------------------------------------------------------------------------------------------------------------------------------X---
XXXXXXXXXXX-----------------------------------------------------------------XXXXXXXXX---------------------------------------------------------------XXXXXXXXXXXX
----------------------------------------------------------------------------------------------------------------------------------------------------XXXXXXXXXXXX
