---------------------------------------------------------------------------------------------------------------------------------------------------------------------------------------------
---------------------------------------------------------------------------------------------------------------------------------------------------------------------------------------------
---------------------------------------------------------------------------------------------------------------------------------------------------------------------------------------------
---------------------------------------------------------------------------------------------------------------------------------------------------------------------------------------------
----------------------------------------------------------------------------------------------------------------------------------oo---------------------------------o-o---------ooo---------
--------------------------------------------------------------oooo----------------------------------------------------------------oo-----------------------------XX--o-o---------XXX---------
--------------------------------------------------------------oooo---------------------------------------------------------------------------------------------------------------------------
--------------------------------------------------------------------E-----------------------------------------------E------------------------------------------------------------------------
-------------------------------------------------------------------------------------------------------ooo--------------ooooo----------------------------------------------------------------
----------------------------oooooooooo----------------XXX------------------------------------XX-------XXXXX--------X---XXXXXXX-------?--------------XXXX---XX---------XX---------------------
---------XXX--XXX-----------oooooooooo-----------------------XX--XX--------------------------X-------------------------------------------------------------XXX-------------------------------
--------XXXXE--------------------------------------------------------------------------------------------------------------------------------------------------------------------------------
-------XXXXX-------------XXXXXXXXXXXEXXXXX---------------------------XX---------------------------------------------------------------------------------------------------------------------X
XXXXXXXXXXX--------------XX-------------XX-XXXXXXXX------------------------XXXXXXXXX----XX-----------------------------------XXX------------XXXXXX-------------------------XXXXXXXXXXX------X
XXXXXXXXXXX--------------XX-------------XX----------------------------------------------X--------------------------------------------XX-----------------------------------------------------X
