---------------------------------------------------------------------------------------------------------------------------------------------------------------------------------------------------------------------------------------------------------------------------------------------------------
-----------------------------------------------------------------------------------------------------------------------------------------------------------------------------------------------------------------------------------------------------E---------------------------------------------------
----------------------QSQ--------o-o-o---------------------------------------------------E--------------E-----------E-----E-----E------------------E---------------QS?-------Eo-o-o-------E---E---E---------------E----E---------------------------QS?--------o-o-o------------------------------Q-------
----------------------------E-----XXXXX--------------E---E-------------------------------?---oo---------------E-------oo------------------oo---E-------------E---------------XXXXXXX--------------------------E-----------------------Q---oo-----------------XXXXXXX-------------------oo--------S--SS-SS
--------------------------------E------X--------------XXX--------------SSS------------------XXXX--------------------------------------E--------------------------------------X------X--------------XXX-----------------XXX---------------XXXX----------------X------X--------E-----------------------oooS
---------------------------------------X--------------X--X----------------------------------X---X------ooo------ooo--------ooo------ooo--------------------------E----------EX------X--------------X--X----------------X--X--------------X---X---------------X------X---ooo----E-ooo-----------------oooS
-------X------------XXXXXX-----XX------X--------------X--X----------------------------------X---X---------------------------------E------------------------------XXXXXX-----XX------X--------------X--X---------E------X--X--------------X---X---XXXXXX-----XX------X--------------------------------oooS
--------------------X-----X----X-XE----X----------XXX-X--X--------SSS--------------------XX-X---X---SSSSSSSSSSSSSSSSSS--SSSSSSSSSSSSSSSSSS---XX----------------E-X-----X----X-X-----X----------XXX-X--X------------XXX-X--X-----------XX-X---X---X-----X----X-X-----XSSSSSSSSSSSSSSSSSS-E------------SSSS
---------------XXXXXX-----X----X-X?----X----------X--XX--X-------------------------------X-XX-o-o-o------------------------------------------X-X---------------XXX-----X----X-X-----X----------X--XX--X------------X--XX--X-----------X-XX-o-o-o-X-----X----X-X-----X------------------------------------
---------------X----X-----X----X-X-----X----------X--XX-XXXX-----------------------------X-XX-XXXXXX-----------------------------------------X-X-----XXXXXXXXXXX-X-----X---EX-X-----X----------X--XX-XXXX----------X--XX-XXXX---X-----X-XX-XXXXXXX-----X----X-X-----X------------------------------------
---------------X----X-----X--XXX-X-----X------XXX-X--XX-X---X----------------------------X-XX-X-----X----------------------------------------X-X-----X-X-------X-X-----X--XXX-X-----X------XXX-X--XX-X---X-----XXX-X--XX-X---X--------X-XX-X-----X-----X--XXX-X-----X------------------------------------
---------------X----X-----X--X---X-----X------X--XX--XX-X---X---------------------<>---XXXXXXXX-----X----------------------------------------X-XXXX--X-X-------X-X-----X--X---X-----X------X--XX--XX-X---X-----X--XX--XX-X---X-<>---XXXXXXXX-----X-----X--X---X-----X-------------------------------X----
------------XXXXX---X-----X--X---XXXX--X-XXX--X--XX--XX-X---X---------------------[]---X-------X----X----------------------------------------X-X-X-X-X-X-------X-X-----X--X---XXXX--X-XXX--X--XX--XX-X---XXXX--X--XX--XX-X---X-[]---X-------X----X-----X--X---XXXX--X----------------------------SSS-----
------------X----X--X-----X--X---XX--X-X-X--X-X--XX--XX-X---X---------------------[]---X-------X----X----------------------------------------X-X-X-X-X-X-------X-X-----X--X---XX--X-X-X--X-X--XX--XX-X---XX--X-X--XX--XX-X---X-[]---X-------X----X-----X--X---XX--X-X------------------------------------
--XXXXXXXXXXXX---X--X--XXXXXXXX--XX--X-X-X--X-X--XX--XX-X---X-------------------XXXXXXXXXXX----X----X----------------------------------------X-X-X-X-X-X-------X-X--XXXXXXXX--XX--X-X-X--X-X--XX--XX-X---XX--X-X--XX--XX-X---XXXXXXXXXXX----X----X--XXXXXXXX--XX--X-X----------------------SSSS----------
