------------------------------------------------------------------------------------------------------------------------------------------------------------------------------------------------------------------------------------------------------------------------------------------------------------------------------------------------------------------------------
----------------------------------------------------------------------------------------------------SSSSSSSSSSSSSSSSSSSSSSSSSSSSSSSSSSSSSSSS--------------------XXXXXXXXXXXXXXXXXXXXXXXXXXXXXXXXXXXXXXXXXXXXXXXXXXXXXXXXXXXXXXXXXXXXXXXXXXXXXXXXXXXXXXXXXXXXXXXXXXXXXXXXXXXXXXXXXXXXXXXXXXXXXXXXXXXXXXXXXXXXXXXXXXXXXXXXXXXXXXXXXXXXXXXXXXXXXXXXXXXXXXXXXXXXXXXXXXXXXXXXXXXXXX
-----------------------------------------------------------------------------------------------------S-------------------S--------------------------------------XXXXXXXXXXXXXXXXXXXXXXXXXXXXXXXXXXXXXXXXXXXXXXXXXXXXXXXXXXXXXXXXXXXXXXXXXXXXXXXXXXXXXXXXXXXXXXXXXXXXXXXXXXXXXXXXXXXXXXXXXXXXXXXXXXXXXXXXXXXXXXXXXXXXXXXXXXXXXXXXXXXXXXXXXXXXXXXXXXXXXXXXXXXXXXXXXXXXXXXXXXXXX-
-----------------------------------------------------------------------------------------------------S----E--------------S--------------------------------------XXXXXXXXXXXXXXXXXXXXXXXXXXXXXXXXXXXXXXXXXXXXXXXXXXXXXXXXXXXXXXXXXXXXXXXXXXXXXXXXXXXXXXXXXXXXXXXXXXXXXXXXXXXXXXXXXXXXXXXXXXXXXXXXXXXXXXXXXXXXXXXXXXXXXXXXXXXXXXXXXXXXXXXXXXXXXXXXXXXXXXXXXXXXXXXXXXXXXXXXXXXXX-
-----------------------------------------------------------------------------------------------------S---S?SQSQSQSQSQSQS-S---SQSQSQSQSQSQSQS--------------------XXXXXXXXXXXXXXXXXXXXXXXXXXXXXXXXXXXXXXXXXX------XXXX----XXXXXXXXXXXXXXXXXXXXXXXXXX------XXXX----XXXXXXXXXXXXXXXXXXXXXXXXXXXXXXXXXXXXXXXXXXXXXXXXXXXXXXXXXXXXXXXXXXXXXXXXXXXXXXXXXXXXXXXXXXXXXXXXXXXXXXXXXXXXX-
-----------------------------------------------------------------------------------------------------S-------------------S-----------------------------------------------XX------------------XX---------------------------------------------XX--------------------------------------XX------------------XX-----------XX-------------------------XX--XXXXXXXXXXXXXXXXXXXXXXXXX-
--------------------------------------------------E--------------------------------------------------S-------------------S---------------------------E----------------E-------------------------------------------------------------------------------------------------------------------------------E---------------------------------------------XXXXXXXXXXXXXXXXXXXXXXXXX-
-----------------------------QQ------------------Q?--------------------------------------------------SSSSo-E-o-o-o-o-SS--SSSSo-o-o-o-o-o-SS----------?Q---------------------------------------------------------------------------------------------------------------------------------X---------oo--------------------------------------oo--------XXXXXXXXXXXXXXXXXXXXXXXXX-
---------------------SSSSS-------SSSS----SSSSS-------SSSS-----------------------------------------------SSSSSSSSSSSSSSS-----SSSSSSSSSSSSSSS--SSSSS-------SSSS-----------------------------------------------------------------------------------------------E-------------------------------------------------------E---------------------------E-E-XXXXXXXXXXXXXXXXXXXXXXXXX-
---------------------------------------------------------------------------------------------------------[]----[]----[]------[]----[]----[]-----------------------------<>------------------<>-------------------------E-----------------------------E---------------------------------------------------XX---------<>---------------------------XX-XXXXXXXXXXXXXXXXXXXXXXXXX-
----------------------------E-------------------E---------------------------------------------E-----SS---[]----[]----[]-SS---[]----[]----[]-----------------------------[]-----E-------E----[]---------------?----------------------------SSS-----E--?-------------------------SSS----------------E------XX---------[]--------------------E------XX-XXXXXXXXXXXXXXXXXXXXXX-XX-
----------------------------SSSS----------------SSSS------------------------------------------------SS---<>----<>----<>-SS---<>----<>--B-<>---------SSSS---------E------[]------------------[]---E-------------------XX--------------------------------------XX-----------------------------------XX------X---------[]---E----------------XX-----XX---------------------------
---------------------------------------------------------------B------------------------------------SS------------------SS-------------b------------------------------<>[]----------------<>[]------------------E---------------SSS---------------------------------------SSS-----------XX--------XX---XXXX-E-----<>[]-----E----XX--------XX---XXXX---------------------------
--<>-----------------------------------------E-----E----------<>------------------<>----------------SS------<>----<>----SS------<>----<>-E-X-----------------------XX-[][]-----XX----E-XX-[][]-----XX---------E-------------XXXX-------------------E----------E-----XXXX----------------XX----E---XX---XXXX----XX-[][]-----XX---XX----E---XX---XXXX---------------------------
--[]SSSS------------SSSSSSSSSSSSSSSSSS--SSSSSSSSSSSSSSSSSS----[]SSSS--------------[]SSSS------------SS-----X[]---X[]SSSSSS-----X[]----[]SSSSSSSSSSSSSSSSSSSSSS--XXXXXXXXXXXXXXXXXXXXXXXXXXXXXXXXXXXXXXXX--XXXXXXXXXXXXXXXXXX----------------------XXXXXXXXXXXXXXXXXX--------------------XX--XXXXXXXX---XXXX-XXXXXXXXXXXXXXXXXXXXXX--XXXXXXXX---XXXX-XXXXXX-X-X-X-X-X-XXXXXXXXX
--SSSSSS------------SSSSSSSSSSSSSSSSSS--SSSSSSSSSSSSSSSSSS----SSSSSS--------------SSSSSS------------SSSSSSSSSSSSSSSSSSSSSSSSSSSSSSSSSSSSSSSSSSSSSSSSSSSSSSSSSS--XXXXXXXXXXXXXXXXXXXXXXXXXXXXXXXXXXXXXXXX---XXXXXXXXXXXXXXXXX-----------------------XXXXXXXXXXXXXXXXX--------------------XX--XXXXXXXX---XXXX-XXXXXXXXXXXXXXXXXXXXXX--XXXXXXXX---XXXX-XXXXXX------------XXXXXXXX
