XXXXXXXXXXXXXXXXXXXXXXXXXXXXXXXXXXXXXXXXXXXX-oooooooooooooo-XXXX-oooooooooooooo-------------------XXXXXXXXXXXXXXXXXXXXXXXXXXXXXXXXXXXXXXXXXXXXXXXXXXXXXXXXXXXXXX-----------------------XXXXXXXXXXXXXXXXXXXXXXXXXXXXXXXXXXSSSSSSSSSSSSSSSSSSSSSSSSSSSSSSSSSSSSSSSSSSSSSSSSSSSSSSSSSSSSSSSSSSSSSSSSSSSSSSSSSSS
XXXXXXXXXXXXXXXXXXXXXXXXXXXXXXXXXXXXXXXXXXXXXXXXXXXXXXXXXXXXXXXXXXXXXXXXXXXXXXXXX----------------XXXXXXXXXXXXXXXXXXXXXXXXXXXXXXXXXXXXXXXXXXXXXXXXXXXXXXXXXXXXXXXX-------<>--------------XXXXXXXXXXXXXXXXXXXXXXXXXXXXXXXXXXSSSSSSSSSSSSSSSSSSSSSSSSSSSSSSSSSSSSSSSSSSSSSSSSSSSSSSSSSSSSSSSSSSSSSSSSSSSSSSSSSS
XXXXXXXX--------XXXXXXXXXXXXXXXXXXXXXXXXXXXXXXXXXXXXXXXXXXXXXXXXXXXXXXXXXXXXXXXXX-------------------XXXXXXXXXXXXXXXXXXXXXXXXXXXX--------XXXXXXXXXXXX--------XXXXXXXXXXXX[]-------------XXXX------------XXXX-----------------------SSSSSSSSX--------------------SSSX----------------SSSX---SSSSSSSSSSSSSSSSSS
XXXXX------------XXXX------------------XXXXXXXXXXXXXXXXXXXXXXXXXXXXXXXXXXXXXXXXXX-------E----------XX------------------XXXXXX------------XXXXXXXX------------XXXXXXXXXXXXXX-------------XX----------------------------------------SSSSSSSSX--------------------SSSX----------------SSSX---SSSSSSSSSSSSSSSSSS
XX-----E----------XX--------------------XXXXXXXXXXXXXXXXXXXXXXXXXXXXXXXXXXXXXXXXX---------------------------------------XX-----E----------XXXX-----E----------XX-----------------------XX--E-----------E---------------E-------E--SSSSSSSSXE-------E----------E--------E----------E-----------------------SS
XX----------------XX-----------------------------------------------------------------E------E---------------------------XX----------------XXXX----------------XX----E------------E------XX------------------------------------------------------------------------------------------------------------E-E-SS
XX---E--------E---XX----------------------E------------E------E------------E--------------------------------------------XX---E--------E---XXXX---E--------E---XX-----------------------XX---------------------X------------------------E--------------------------------------------------------------------
XX----------------XX----------------------------------------------------------------------------------------------------XX----------------XXXX----------------XX-----------------------QQ-------SSSSSX-------X-X------------------SSSSSSSS------------------------------------------------------------------
XX----------------XX-------------------------------------------------------------X--------------------------------------XX----------------XXXX----------------XX-----------------------SS-------S-----------X---X-----------------SSSSSSSS------------------------------------E-----------------------------
XX-X--------------------------<>------------------------------------------------------------------------------<>--------XX------------------XX---------X---------------------X---------SS-------S----------X-----X------------SSX---------------------------------------------------------------------------
XX-----QSQSQ--------------<>--[]---<>----------------------X--------------------<>------------------------<>--[]---<>---XX-----QSQSQ--------XX-----QSQSQ--------------------XXX--------SS-o-oEo-S---------XoooEoooS------SSSX-SSX------------------------E------------------------------------------E----SSS
---------------------<>---[]--[]---[]-------------------------------------------[]-------------------<>---[]--[]---[]------------------------------------E-----------------XXXXX---------XXXXXXXX--------Xoooo?ooooS-----SSSX-SSSSSSSSSSSSSS----SS------------------SS--------------E--------------------SSS
-------------XX------[]---[]--[]---[]---XXXXXXXXXXXX<>XXXX<>XXXXXXXXXXXX<>XXXX<>[]-------------------[]---[]--[]---[]----------------XX----------------E-XX---------------XXXXXXX----------o-o-o--------XoooooooooooX----SSSX-SSSSSSSSSSSSSSX---SS---------E---SSSSSSS-------------SSSSSSSXXXXXXXXXXXXXXXSSS
-------------XX------[]---[]--[]---[]---XXXXXXXXXXXX[]XXXX[]XXXXXXXXXXXX[]XXXX[][]-------------------[]---[]--[]---[]----------------XX------------------XX--------------XXXXXXXXX----XXXXXXXXXXXXXXXXXXXooooooooooooXSSSSSSX-SSSSSSSSSSSSSSX---SS-------XXXXXXSSSSSSS-------XXXXXXSSSSSSS---------------SSS
XXXXXXXXXXXXXXXXXXXXXXXXXX[]--[]--XXXXXXXXXXXXXXXXXXXXXXXXXXXXXXXXXXXXXXXXXXXXXXXXXXXXXX----XXXXXXXXXXXXXX[]--[]--XXXXXXXXXXXXXXXXXXXXXXXXXXXXXXXXXXXXXXXXXXXXXX----XXXXXXXXXXXXXXXX-----------------------SX---------SSSSSSX-SSSSSSSSSSSSSSX---SS--SSSS-------SSSSSSS--SSSS-------SSSSSSS---------------SSS
XXXXXXXXXXXXXXXXXXXXXXXXXX[]--[]---XXXXXXXXXXXXXXXXXXXXXXXXXXXXXXXXXXXXXXXXXXXXXXXXXXXX------XXXXXXXXXXXXX[]--[]---XXXXXXXXXXXXXXXXXXXXXXXXXXXXXXXXXXXXXXXXXXXXXX----XXXXXXXXXXXXXXSSSSSSSSSSSSSSSSSSSSSSSSSSSSSSSSSS-SSSSSSX-SSSSSSSSSSSSSSX---SS--SSSS-------SSSSSSS--SSSS-------SSSSSSS---------------SSS
